NO ./assets/armenistan.xpm
SO ./assets/pakistan.xpm
WE ./assets/turkmenistan.xpm
EA ./assets/uzbekistan.xpm

F 200, 100, 50
C 256, 255, 100

11111111111111
10000000000001
10000000N00001
10000000000001
11111111111111