NO ./assets/armenistan.xpm
SO ./assets/pakistan.xpm
WE ./assets/turkmenistan.xpm
EA ./assets/uzbekistan.xpm

F 100, 100, 100
C 200, 200, 200

1111111111111111111111111
1000000000000000000000001
1000N01111111110000000001
1000001111111110000000001
1000000000000000000000001
1000000000011111111111111
111111111111
