11111111111111111111111
10000000000000001000001
100000000W0000001000001
10000000000000000000001
10000001000000000000001111111111
10000001000000000000000000000001
10000001000000000000000000000001
11111111111111111111111111111111

F 100, 100, 100
C 200, 20, 20

NO ./assets/armenistan.xpm
SO ./assets/pakistan.xpm
WE ./assets/turkmenistan.xpm
EA ./assets/uzbekistan.xpm