NO ./assets/armenistan.xpm
SO ./assets/pakistan.xpm
WE ./assets/turkmenistan.xpm
EA ./assets/uzbekistan.xpm

C 0, 0, 0
F 255, 255, 255

11111111111111111111111111111111111111111111111111
10000000000000000000000000000000000000000000000001
100000000000E0000000000000000000000000000000000001
10000000000000000000000000000000000000000000000001
11111111111111111111111111111111111111111111111111
